die Anwendung - the application
die Rubrik - the category
die Anlage - the facility
die Förderung - the sponsorship
der Abschnitt - the period
der Inhalt - the content
der Eintritt - the admission
der Durchschnitt - the average
der Verlust - the damage
die Eröffnung - the opening
der Anteil - the share
das Ereignis - the occasion
die Reparatur - the repair
die Versorgung - the supply
der Rest - the remainder
die Geschwindigkeit - the speed
die Auflage - the edition
der Umfang - the circumference
die Oberfläche - the surface
die Verpflichtung - the obligation
das Niveau - the level
die Agentur - the agency
die Vorstellung - the vision
der Vortrag - the lecture
der Bezug - the salary
die Gewalt - the violence
die Einstellung - the setting
die Runde - the circle
der Empfang - the reception
der Eingang - the entrance
der Abschluss - the degree
der Umgang - the interaction
der Ansatz - the approach
die Schau - the show
die Vermittlung - the agency