einige - a few
bereits - already
etwa - approximately
gerade - just now
doch - however
eigentlich - actually
oben - up there
nun - now
eben - just now
solch - such
gar - at all
möglichst - if possible
Fall - case
eigen - own
zwar - admittedly
gelten - to be valid
jedoch - however
sowie - as well as
allerdings - though
wohl - well
bestimmt - certain
überhaupt - generally
besonders - especially
entsprechen - to correspond
Bereich - region
kaum - hardly
einzeln - individual
deshalb - for that reason
na - well,
beziehungsweise - respectively
sogar - even
damals - then
wegen - because of
Gesellschaft - society
entstehen - to originate
erhalten - to receive
Möglichkeit - possibility
sonst - otherwise
das Unternehmen - the enterprise
die Stelle - the place
vorstellen - to introduce
erreichen - to reach
anders - differently
schließlich - in the end
eher - earlier
je - each
je ... desto - the ... the
drinnen - inside
die Aufgabe - the assignment
schaffen - to manage
im Sinne - according to
der Staat - the state
daher - from there
obwohl - although
verlieren - to lose
vor allen Dingen - above all
deutlich - clear
allgemein - general
auf den ersten Blick - at first sight
einzig - single
darstellen - to depict
gemeinsam - mutual
dessen - whose
mehrere - several
zunächst - at first
sozial - social
bisher - until now
nämlich - namely
naja - oh well
betreffen - to affect
ab und zu - every now and then
gewiss - certain
eine Rolle spielen - to be relevant
vergehen - to pass (time)
Bedeutung - meaning
ach - oh
das Ergebnis - the result
gewinnen - to win
die Weise - the way
Regierung - government
wahrscheinlich - probable
europäisch - European
das Gespräch - the conversation
wesentlich - essential
erinnern - to remind
der Punkt - the dot
ergeben - to result in
häufig - frequent
ebenso - as much as
danach - afterwards
Abbildung - illustration
der Begriff - the concept
verbinden - to connect
der Boden - the floor
das Jahrhundert - the century
vergleichen - to compare
außerdem - in addition
inzwischen - in the meantime
steigen - to climb
der Rahmen - the frame
gering - small
verlassen sich auf jdn - to depend on smb
einsetzen - to insert
ändern - to change
wachsen - to grow
ausgehen - to go out
die Regel - the rule
der Schritt - the step
der Absatz - the paragraph
Gott sei Dank - Thank God
Erfahrung - experience
annehmen - to accept
kriegen - to get
planen - to plan
das Gefühl - the feeling
bezeichnen - to describe
innerhalb - within
insbesondere - particularly
die Partei - the (political) party
tatsächlich - actual
befinden sich - to be
das Verhältnis - the relationship
zusätzlich - additional
aufgrund - due to
hin und her - back and forth
hin und wieder - every now and then
amerikanisch - American
ebenfalls - likewise
nachdem - after
wirtschaftlich - financial
aufnehmen - to pick up
der Gedanke - the thought
zunehmen - to increase
bestimmen - to decide
fordern - to demand
schlagen - to beat
trotz - in spite of
Entscheidung - decision
treten - to step
der Betrieb - the business
gleichzeitig - simultaneous
der Zusammenhang - the connection
das Gesetz - the law
jedenfalls - in any case
die Kraft - the strength
lachen - to laugh
verwenden - to use
wählen - to choose
erfolgen - to take place
gesamt - whole
speziell - specific
bloß - just
enthalten - to contain
betrachten - to consider
entscheiden - to decide
der Erfolg - the success
gelingen - to succeed
die Grenze - the border
jeweils - each time
der Satz - the sentence
das Angebot - the offer
darum - therefore
pro - per
eng - narrow
insgesamt - altogether
die Lage - the location
die Leistung - the performance
stattfinden - to take place
vorher - beforehand
beispielsweise - for example
feststellen - to establish
verschwinden - to disappear
meist - mostly
auftreten - to appear
das Auftreten - the appearance
notwendig - necessary
rein - pure
sowohl ... als auch - both ... and
stimmen - to be correct
verhalten sich - to behave
zudem - moreover
berichten - to report
die Höhe - the height
rechnen - to calculate
fremd - foreign
mindestens - at least
der Vergleich - the comparison
das Mittel - the means
zumindest - at least
der Kunde - the customer
der Tod - the death
unterscheiden - to distinguish
wahr - true
das Geschäft - the business
leisten - to achieve
verlangen - to request
werfen - to throw
Bewegung - movement
der Einsatz - the inset
das Gebiet - the area
vorstellen - to present
der Rechtsanwalt - the lawyer
Bestimmung - regulation
die Basis - the foundation
Planung - planning
Eigenschaft - quality
Unterstützung - encouragement
die Menge - the amount
der Zugang - the access
der Vorschlag - the proposal
Einführung - introduction
der Hintergrund - the background
der Verlauf - the process
Anleitung - guide
Verwendung - usage
die Spalte - the crack
das Gewicht - the weight
Einzelheit - detail
Wirkung - effect
die Stufe - the step
der Kreis - the circle
Umsetzung - implementation
der Einsatz - the deployment
kam zum Einsatz - was used
der Überblick - the overview
der Zustand - the condition
die Tabelle - the chart
die Ware - the product
die Lieferung - the delivery
steht zum Verkauf - is for sale
die Garantie - the warranty
ablaufen - to expire
der Auftrag - the order
ausführen - to execute
die Anzeige - the advertisement
die Messe - the trade fair
Bewertung - assessment
der Service - the service
Werbung - advertising
Bezahlung - payment
der Antrag - the application
stellen - to place
das Lager - the storage
die Marke - the brand
die Ausgabe - the edition
die Börse - the stock exchange
das Stellenangebot - the job offer
Gründung - founding
Dienstleistung - service
verhandeln - to negotiate
die Branche - the branch of industry
der Einzelhandel - the retail
der Bedarf an - the need for
die Logistik - the logistics
auswählen - to choose
ermöglichen - to make possible
festlegen - to determine
vermeiden - to avoid
erfüllen - to fulfill
ansehen - to watch
entfernen - to remove
sorgen - to take care of
sparen - to save money
knapp - barely
zumachen - to close
anzeigen - to show
nachlassen - to decrease
der Ball - the ball
das Team - the team
das Hobby - the hobby
die Aktivität - the activity
die Mannschaft - the team
der Zuschauer - the spectator
der Sieg - the victory
die Liga - the league
die Teilnahme - the participation
der Ski - the ski
das Schwimmbad - the swimming pool
die Wette - the bet
laufen um die Wette - to run a race
gründen - to found
die Gemeinde - the community
du hast mich dazu gebracht - you made me do this
die Kunst - the art
die Ausstellung - the exhibition
das Studio - the studio
der Musiker - the musician
die Gitarre - the guitar
die Galerie - the gallery
der Künstler - the artist
das Theater - the theatre
malen - to paint
das Instrument - the instrument
die Kultur - the culture
der Entwurf - the draft
das Modell - the model
die Regie - the direction
beliebt - popular
das Design - the design
das Lied - the song
die Sammlung - the collection
bieten - to offer
die Sehenswürdigkeit - the sight
das Publikum - the audience
die Kritik - the review
der Tanz - the dance
der Stil - the style
die Bühne - the stage
die Mode - the fashion
aus der Mode - out of fashion
die Kamera - the camera
die Tätigkeit - the activity
laden - to charge
der Schauspieler - the actor
die Plastik - the sculpture
das Plastik - the plastic
begeistert von - enthusiastic about
gebären - to give birth to
bewerten - to evaluate
berücksichtigen - to take into account
gewährleisten - to guarantee
bevorzugen - to prefer
der Priester - the priest
beten - to pray
der Glaube - the belief
das Paradies - the paradise
der Christ - the christian
heilig - holy
das Gebet - the prayer
die Wiedergeburt - the reincarnation
der Jude - the jew
die Kirche - the church
die Synagoge - the synagogue
der Tempel - the temple
die Moschee - the mosque
der Mönch - the monk
unterschreiben - to sign
zerstören - to destroy
das Hochwasser - the high tide
braten - to roast
arm - poor
kämpfen - to fight
einer Sache begegnen - to encounter smth
jdm drohen - to threaten smb
raten - to advise
schaden - to harm
vertrauen - to trust
jdm einfallen - to occur to smb
genugen - to be enough
glücken - to be a success
vorkommen - to happen
retten - to save
mitteilen - to tell smb smth
der Rundfunk - the broadcasting
die Erkältung - the cold
versäumen - to miss
ausführlich - detailed
die Krise - the crisis
das Verbrechen - the crime
der Vorort - the suburb
der Pfleger - the nurse
verbergen vor jdm - to hide from smb
verlieben in jdn - to fall in love with smb
achten auf eine Sache - to pay attention to smth
sich beklagen über eine Sache - to complain about smth
erkennen an einer Sache - to recognize by smth
sich freuen auf eine Sache - to look forward to smth
sich freuen über eine Sache - to be glad about smth
glauben an eine Sache - to believe in smth
hoffen auf eine Sache - to hope for smth
sich irren in eine Sache - to be wrong about smth
leiden an einer Sache - to suffer from smth
reden über eine Sache - to talk about smth
schreiben an jdn - to write to smb
schreiben über eine Sache - to write about smth
schützen vor einer Sache - to protect from smth
sterben an einer Sache - to die from smth
teilnehmen an einer Sache - to participate in smth
sich verlassen auf eine Sache - to rely on smth
verzichten auf eine Sache - to do without smth
warnen vor einer Sache - to warn against smth
der Bekannte - the acquaintance
der Frosch - the frog
der Felsen - the rock
der Kranke - the ill person
weinen über eine Sache - to cry over smth
verhaften - to arrest
vorsichtig - cautious
hüten vor jdm - to guard against smb
der Dieb - the thief
die Gefahr - the danger
schreien - to shout
fluchen - to swear
durchziehen - to go through
der Dichter - the poet
das Gedicht - the poem
backen - to bake
sämtlich - all
klug - clever
stolz - proud
nett - nice
scharf - sharp
auswandern - to emigrate
hübsch - lovely
fleißig - hard_working
erfreuen - to delight
eifrig - eager
schick - stylish
begründen - to give reasons for
berühmt - famous
der Fußgänger - the pedestrian
auswendig - by heart
gleichen - to be alike
die Birne - the pear
örtlich - local
das Gefängnis - the prison
der Packen - the heap
geloben - to vow
das Gemälde - the painting
die Quittung - the receipt
der Ausflug - the trip
abhängen von einer Sache - to depend on smth
heizen - to heat
sehenswert - worth seeing
die Tinte - the ink
die Geige - the violin
treu - loyal
der Schriftsteller - the author
trocken - dry
das Wachstum - the growth
schädlich - harmful
angenehm - pleasant
peinlich - embarrassing
äußert - extremely
äußern - to express
verbrechen - to commit
die Mappe - the briefcase
das Plätzchen - the biscuit
der Schaffner - the conductor
bitten - to ask
der Eintritt - the entry
der Gipfel - the peak
das Blatt - the leaf
vertrocknen - to dry out
die Wärme - the warmth
verderben - to spoil
die Wandtafel - the blackboard
der Reisende - the traveller
heben - to raise
putzen - to polish
stoßen - to kick
faul - bad
die Kreide - the chalk
abfahren - to depart
anstatt - instead of
schweigen - to be quiet
regnerisch - rainy
klagen - to moan
der Mieter - the tenant
das Gericht - the dish
der Blumenstrauß - the bouquet of flowers
beobachten - to observe
leuchten - to shine
lächeln - to smile
befehlen - to order
die Armee - the army
angreifen - to attack
greifen - to take hold of
treiben - to push
fangen - to catch
arrangieren - to arrange
verloben - to become engaged
der Schatz - the treasure
der Nagel - the nail
riesig - enormous
renovieren - to renovate
erben - to inherit
borgen - to borrow
aufhören - to stop
mitkommen - to come along
aussprechen - to pronounce
kümmern - to worry
reinigen - to clean
atmen - to breathe
zugeben - to add
stören - to disturb
schneiden - to cut
das Hauptgericht - the main course
der Gürtel - the belt
bügeln - to iron
das Loch - the hole
graben - to dig
artig - well_behaved
die Decke - the blanket
zudecken - to cover up
das Gepäck - the luggage
ärgern - to annoy
sich benehmen - to behave
sich erholen - to recover
sich erkälten - to catch a cold
sich fragen - to wonder
sich unterhalten - to converse
die Reihe - the row
verzeihen - to forgive
die Dummheit - the stupidity
bergen - to rescue
der Pelz - the fur
so gut ich kann - as best I can
der Bettler - the beggar
widersprechen jdm - to contradict smb
zuschreiben einer Sache - to attribute to smth
beschreiben - to describe
empfinden - to feel
entlaufen - to run away
entschließen - to decide
erschlagen - to kill
missachten - to ignore
misslingen - to be unsuccessful
zerreißen - to tear to pieces
zerschmettern - to smash
ankommen - to arrive
beibringen - to teach
fortfahren - to continue
nachahmen - to imitate
durchfallen - to fail
sich übersehen - to get fed up
umkommen - to die
unterkommen - to find accommodation
widerrufen - to retract
wiedergeben - to give back
durchdringen - to penetrate
hintergehen - to deceive
übertreiben - to exaggerate
umarmen - to embrace
unterbrechen - to interrupt
vollziehen - to carry out
widerspiegeln - to reflect
behaupten - to claim
erfinden - to make up
einschlafen - to fall asleep
entfliehen - to escape
versprechen - to promise
der Aufsatz - the essay
empfangen - to receive
der Ritter - the knight
der Drache - the dragon
umbringen - to murder
austrinken - to drink up
vorschlagen - to suggest
gehorchen - to obey
unterrichten - to teach
vorbereiten - to prepare
die Abreise - the departure
die Hälfte - the half
bestehen - to pass
das Abteil - the compartment
vertragen - to tolerate
streiten um eine Sache - to argue about smth
begleiten - to accompany
gleiten - to glide
schaufeln - to shovel
taub - deaf
damit - so that
indem - by
seitdem - since
beherrschen - to master
beeilen - to hurry up
pünktlich - punctual
hinlegen - to put down
verreisen - to go away on a trip
loben - to praise
frieren - to be cold
ehe - before
bedauern - to regret
die Klingel - the bell
beabsichtigen - to intend
imponieren jdm - to impress smb
bedauren - to regret
lügen - to lie
soviel - as far as