å vite - to know
vet - knows
hva - what
hvor - where
å bo - to live
velkommen - welcome
en dag - a day
en kveld - an evening
å kjøpe - to buy
en elg - a moose
en edderkopp - a spider
en ulv - a wolf
unnskyld - sorry
vær så snill - please
eller - or
kanskje - maybe
bra - nice
hyggelig - pleasant
en natt - a night
en helg - a weekend
å lage - to make
flere - several
mange - many
å gjø - to do
å sove - to sleep
å høre - to hear
å velge - to choose
å selge - to sell
å arbeide - to work
å vaske - to wash
å vente - to wait
når - when
om - about
å stå - to stand
å bestille - to order
hvordan - how
med - with
utenfor - outside
mer - more
en stol - a chair
et bord - a table
en lunsj - a lunch
en kake - a cake
til - more
en - one
to - two
tre - three
fire - four
fem - five
seks - six
sju - seven
åtte - eight
ni - nine
ti - ten
å tro - to think
å si - to say
sier - says
å lytte - to listen
å komme - to come
å bety - to mean
til - to
fra - from
nå - now
snart - soon
ofte - often
aldri - never
hvorfor - why
hvordan går det - how is it going
en nabo - a neighbour
en gjest - a guest
å eie - to own
å tilhøre - to belong
et rom - a room
et navn - a name
en telefon - a telephone