außerdem - in addition
knapp - barely
die Regie - the direction
nachlassen - to decrease
zudem - moreover
Anleitung - guide
die Tabelle - the chart
laden - to charge
wesentlich - essential
Gesellschaft - society
ebenfalls - likewise
ebenso - as much as
sorgen - to take care of
der Entwurf - the draft
die Lage - the location
betreffen - to affect
bloß - just
eine Rolle spielen - to be relevant
Einzelheit - detail
Verwendung - usage
der Zustand - the condition
bieten - to offer
genugen - to be enough
die Tätigkeit - the activity
enthalten - to contain
der Rundfunk - the broadcasting
gelingen - to succeed
versäumen - to miss
fordern - to demand
wirtschaftlich - financial
eigentlich - actually
vorher - beforehand
festlegen - to determine
der Bedarf an - the need for